source	target
3DFR  	3 day food record
AA    	amino acids
AAA   	aromatic amino acid
AAB   	Acetic acid bacteria
AAC   	apparent amylose content
AAF   	amino acid fraction
AAN   	amino acid nitrogen
AB    	ammonium bicarbonated
ABC   	apoptotic body count
AC    	antioxidant capacity
ACA   	adrenal cortex antibodies
ACD   	adult coeliac disease
ACE   	Angiotensin converting enzyme
ACL   	Acquired cutis laxa
ACS   	annealed cassava starch
AD    	Atopic dermatitis
ADC   	apparent diffusion coefficient
ADF   	acid detergent fiber
ADG   	average daily gain
ADHD  	attention deficit hyperactivity disorder
ADIN  	acid detergent insoluble nitrogen
ADOS  	Autism Diagnostic Observation Schedule
AEDA  	aroma extract dilution analyses
AF    	atrial fibrillation
AFB   	amaranth flour blend
AFM   	atomic force microscopy
AFR   	adverse food reactions
AG    	acylated ghrelin
AGA   	and gliadin antibodies
AGCB  	added gluten content bread
AGE   	Advanced glycation end
AH    	alfalfa hay
AHPWS 	alkaline hydrogen peroxide-treated wheat straw
AI    	Antibody indices
AIAAD 	apparent ileal amino acid digestibility
AID   	apparent ileal digestibility
AIPD  	apparent ileal P digestibility
AL    	ad libitum
ALAB  	amylolytic lactic acid bacteria
ALC   	alcoholic liver cirrhosis
ALS   	amyotrophic lateral sclerosis
AM    	association mapping
AMF   	arbuscular mycorrhizal fungi
AMS   	automatic milking system
AN    	Anorexia nervosa
AND   	apparent N digestibility
ANI   	alive newborn infants
ANN   	artificial neural network
ANS   	autonomic nervous system
AOR   	adjusted odds ratio
AP    	alkaline phosphatase
APC   	antigen presenting cells
APF   	Apple pomace flour
API   	asthma predictive index
APP   	apple pomace powder
APS   	autoimmune polyglandular syndrome
APT   	and prednisone therapy
APTT  	Activated Partial Thromboplastin Time
APW   	alveograph parameter W
AR    	autosomal recessive
ARA   	anti reticulin antibody
ARA2  	angiotensin receptor antagonist 2
ARB   	angiotensin receptor blockers
ARMS  	amplification refractory mutation system
ARPS  	adjusted ruminal protein S
AS    	ankylosing spondylitis
ASA   	active systemic anaphylaxis
ASCT  	Autologous stem cell transplantation
ASD   	autism spectrum disorder
ASF   	Alfalfa seed flour
ASKG  	Artemisia sphaerocephala Krasch gum
ASV   	amplicon sequence variant
AT    	Autoimmune thyroiditis
ATD   	autoimmune thyroid disease
ATI   	amylase trypsin inhibitors
ATR   	attenuated total reflectance
ATTD  	apparent total tract digestibility
AU    	arbitrary units
AUC   	area under curve
AWRC  	alkaline water retention capacity
B1    	basal 1
B2    	basal 2
BA    	bone age
BAC   	bacterial artificial chromosome
BAM   	Brewster angle microscopy
BAP   	bone alkaline phosphatase
BAT   	basophil activation test
BBFC  	brush border folate conjugase
BBS   	broad bean stalks
BC    	bacterial cellulose
BCA   	Brazilian Celiac Association
BCAA  	branched chain amino acid
BCM   	body cell mass
BCS   	body condition score
BD    	bullous dermatosis
BDA   	British Dietetic Association
BDI   	Beck Depression Inventory
BE    	base excess
BEAA  	Bile Esculin Azide Agar
BEF   	buriti endocarp flour
BES   	Binge Eating Scale
BF    	buckwheat flour
BFB   	basic food basket
BFL   	bound flour lipid
BGG   	bovine gamma globulin
BH    	body height
BHP   	Bill Henderson Protocol
BIN   	Borate-phosphate insoluble N
BKM   	basic knowledge models
BLP   	broccoli leaf powder
BM    	blood meal
BMAD  	bone mineral apparent density
BMC   	bone mineral content
BMD   	Bone mineral density
BMI   	body mass index
BMQ   	bread making qualities
BMT   	bone marrow transplantation
BMZ   	basement membrane zone
BN    	Brown Norway
BO    	bran oleoresin
BOD   	biochemical oxygen demand
BP    	bullous pemphigoid
BR    	biogas residue
BRBNS 	blue rubber bleb nevus syndrome
BS    	Binder syndrome
BSA   	bovine serum albumin
BSE   	bovine spongiform encephalopathy
BSFS  	Bristol Stool Form Scale
BSMV  	Barley stripe mosaic virus
BT    	baking time
BTT   	bone transmission time
BUN   	blood urea nitrogen
BV    	biological value
BVDV  	bovine viral diarrhea virus
BW    	body weight
BWG   	Body weight gain
CA    	carbonic anhydrase
CAA   	cellular antioxidant activity
CAD   	chemically acidified dough
CAG   	chronic active gastritis
CAH   	chronic active hepatitis
CALLA 	common acute lymphoblastic leukaemia antigen
CAM   	cell adhesion molecules
CAP   	calibration and prediction
CARS  	Childhood Autism Rating Scale
CART  	classification and regression tree
CAT   	chloramphenicol acetyl transferase
CBC   	complete blood count
CC    	Celiac crisis
CCA   	Canadian Celiac Association
CCD   	classical celiac disease
CCG   	Clinical Commissioning Group
CCPR  	crypt cell production rate
CCR   	CC chemokine receptor
CD    	Celiac disease
CDA   	celiac disease autoimmunity
CDAQ  	Coeliac Disease Assessment Questionnaire
CDAT  	Celiac Dietary Adherence Test
CDQ   	Celiac Disease Questionnaire
CDR   	cell danger response
CDS   	condensed distillers solubles
CDSD  	Celiac Disease Symptom Diary
CE    	capsule endoscopy
CEC   	coronary endothelial cells
CECS  	Canine epileptoid cramping syndrome
CF    	cystic fibrosis
CFD   	control formulated diet
CFE   	cell free extract
CFG   	corn fiber gum
CFS   	corn fermentation solubles
CFWN  	Chinese fresh white noodles
CG    	corn gluten
CGA   	chick growth assay
CGD   	chronic granulomatous disease
CGE   	crude gliadin extract
CGF   	corn gluten feed
CGH   	Corn gluten hydrolysate
CGM   	corn gluten meal
CHB   	chronic hepatitis B
CHC   	child health centre
CHD   	congenital heart disease
CHO   	Chinese hamster ovary
CI    	confidence interval
CIA   	celiac intestinal antibody
CIAP  	Chronic idiopathic axonal polyneuropathy
CIC   	circulating immune complexes
CIG   	chronic inactive gastritis
CIR   	Cosmetic Ingredient Review
CIT   	Critical Incident Technique
CJAP  	cold jet atmospheric pressure
CK    	creatine kinase
CL    	corpus luteum
CLA   	conjugated linoleic acid
CLE   	confocal laser endomicrosopy
CLF   	coarse lentil flour
CLL   	chronic lymphatic leukemia
CLO   	cod liver oil
CLSM  	confocal laser scanning microscopy
CLT   	cytotoxic leucocyte test
CM    	canola meal
CMC   	Carboxy Methyl Cellulose
CMLNS 	cavitating mesenteric lymph node syndrome
CN    	control noodle
CNS   	central nervous system
CNSB  	Chinese northern steamed bread
COD   	chemical oxygen demand
COV   	coefficient of variation
CP    	crude protein
CPE   	childhood partial epilepsy
CPH   	corn protein hydrolysates
CPP   	Carrot pomace powder
CPT   	carnitine palmitoyl transferase
CR    	conception rate
CRNPR 	Corrected relative net protein ratio
CRP   	C reactive protein
CRS   	congenital rubella syndrome
CRVO  	central retinal vein occlusion
CS    	celiac sprue
CSB   	Chinese steamed bread
CSC   	cotton seed cake
CSF   	chia seed flour
CSG   	chronic superficial gastritis
CSI   	celiac symptom index
CSL   	concentrated steep liquor
CSP   	cortical silent period
CSWF  	chlorinated soft wheat flour
CT    	Computed tomography
CTB   	cholera toxin B-subunit
CTD   	Comparative Toxicogenomics Database
CTE   	chronic traumatic encephalopathy
CTLA4 	CD28-cytotoxic T lymphocyte antigen 4
CU    	chronic urticaria
CUS   	Chronic ulcerative stomatitis
CVID  	Common Variable Immunodeficiency Disorder
CVST  	Cerebral venous sinus thrombosis
CWF   	control wheat flour
CY    	compressed yeast
CYP   	Chinese yam powder
CZE   	capillary zone electrophoresis
DAA   	days after anthesis
DAF   	days after flowering
DAH   	diffuse alveolar hemorrhage
DAS   	disease activity score
DBE   	double balloon enteroscopy
DC    	Dendritic cells
DCGF  	dry corn gluten feed
DCM   	Delignified Cellulosic Materials
DCP   	digestibility crude protein
DCS   	damaged cassava starch
DD    	deamidation degree
DDA   	data dependent acquisition
DDG   	dried distillers grains
DDS   	drug delivery systems
DDT   	dough development time
DDW   	Digestive Diseases Week
DE    	digestible energy
DED   	dental enamel defects
DEG   	Differentially expressed genes
DEXA  	Dual Energy X-ray Absorptiometry
DF    	dietary fibre
DFB   	dehulled faba bean
DFT   	density functional theory
DG    	dry gluten
DGA   	dietary gluten avoidance
DGP   	deamidated gliadin peptides
DGPF  	dehydrated green pea flour
DH    	Dermatitis herpetiformis
DI    	distal intestine
DIL   	duodenal intraepithelial lymphocytosis
DIM   	d in milk
DIP   	degradable intake protein
DIS   	dilated intercellular space
DIT   	diet induced thermogenesis
DL    	Dough liquor
DLA   	diffusion limited aggregation
DLQI  	Dermatology Life Quality Index
DLS   	dynamic light scattering
DM    	dry matter
DMA   	dynamic mechanical analysis
DMD   	dry matter digestion
DMH   	duodenal mucosa healing
DMI   	dry matter intake
DMP   	dried molasses product
DMTA  	dynamic mechanical thermal analysis
DOE   	design of experiments
DOH   	Department of Health
DOR   	diagnostic odds ratios
DP    	digestible protein
DPU   	dual-frequency power ultrasound
DPV   	differential pulse voltammetry
DQ    	diet quality
DQOL  	diabetes-specific quality of life
DS    	Down syndrome
DSA   	dietary supplementation advice
DSAA  	digestible sulfur amino acid
DSC   	differential scanning calorimetry
DSM   	dried skim milk
DSS   	dextran sulfate sodium
DT    	development time
DTG   	dehydrated turf grass
DUB   	dysfunctional uterine bleeding
DVA   	Duodenal villous atrophy
DVT   	deep vein thrombosis
DW    	dry weight
DWS   	durum wheat semolina
DXA   	dual-energy X-ray absorptiometry
DY    	Diagnostic yield
EA    	emulsifying activity
EAA   	essential amino acid
EAAT3 	excitatory amino acid transporter 3
EAC   	erythema annulare centrifugum
EAE   	experimental autoimmune encephalitis
EAI   	emulsifying activity index
EAR   	estimated average requirements
EATL  	enteropathy associated T-cell lymphoma
EB    	Epidermolysis bullosa
EBD   	Evans blue dye
EC    	European Commission
ECAP  	equal channel angular pressing
ECF   	extruded corn flour
ECH   	enterocyte cell height
ECIS  	electrical cell-substrate impedance sensing
ECP   	eosinophil cationic protein
EDI   	estimated daily intakes
EDL   	estimated detection limit
EDSS  	Expanded Disability Status Scale
EE    	eosinophilic esophagitis
EED   	Erythema elevatum diutinum
EF    	ejection fraction
EFSA  	European Food Safety Authority
EG    	experimental group
EGF   	epidermal growth factor
EGFP  	enhanced green fluorescent protein
EGFR  	epidermal growth factor receptor
EH    	enamel hypoplasia
EHG   	enzymatically hydrolyzed glutens
EI    	electrochemical immunosensor
EIA   	enzyme immuno assay
EID   	effective intestinal digestibility
EIS   	electrochemical impedance spectroscopy
EISC  	extended inverted signal correction
EM    	egg mass
EMR   	electronic medical record
EMSC  	extended multiplicative signal correction
ENA   	extractable nuclear antigens
ENF   	epidermal nerve fiber
EP    	escape protein
EPES  	exocrine pancreas enzyme supplementation
EPI   	Exocrine pancreatic insufficiency
EPL   	endogenous P losses
EQA   	external quality assurance
ER    	endoplasmic reticulum
ERK   	extracellular response kinase
ES    	emulsion stability
ESO   	Epoxidized soybean oil
ESR   	erythrocyte sedimentation rate
EST   	expressed sequence tag
ET    	essential thrombocythemia
ETD   	electron transfer dissociation
ETL   	enteropathy-type T-cell lymphoma
ETP   	endogenous thrombin potential
EU    	European Union
EUN   	endogenous urinary N
EW    	Egg White
EWP   	egg white protein
EWS   	egg white sandwich
EZP   	exchangeable zinc pool
FA    	fatty acids
FAA   	free amino acids
FABP  	Fatty acid binding proteins
FACE  	Free Air CO2 Enrichment
FACS  	fluorescence activated cell sorting
FAD   	flavin adenine dinucleotide
FAIM  	Food Allergy Independent Measure
FAIMS 	Field Asymmetric Ion Mobility Spectrometry
FAK   	focal adhesion kinase
FAN   	free amino nitrogen
FAP   	Functional abdominal pain
FAPAS 	Food Analysis Performance Assessment Scheme
FAS   	fatty acid synthase
FB    	field beans
FBC   	ferrous bisglycinate chelate
FBD   	functional bowel disorder
FBH   	fasting breath hydrogen
FC    	fecal calprotectin
FCR   	feed conversion ratio
FCS   	fetal calf serum
FD    	Functional dyspepsia
FDR   	first degree relatives
FE    	feed efficiency
FER   	feed efficiency ratio
FF    	fluorescence fingerprint
FFA   	free fatty acids
FFF   	Flow field-flow fractionation
FFL   	free flour lipid
FFM   	fat free mass
FFQ   	food frequency questionnaire
FG    	flaxseed gum
FGA   	faecal glutenasic activity
FGISH 	Fluorescence genomic in situ hybridization
FH    	food hypersensitivity
FHP   	fasting heat production
FI    	food intolerance
FID   	free induction decay
FIQ   	Fibromyalgia Impact Questionnaire
FISH  	fluorescence in situ hybridization
FL    	full length
FLF   	fine lentil flour
FM    	fish meal
FM1   	fish meal 1
FMF   	Familial Mediterranean fever
FN    	falling number
FNS   	Food Neophobia Scale
FO    	fish oil
FOS   	fixation off sensitivity
FPE   	food protein-induced enteropathy
FPIR  	first phase insulin response
FPLC  	fast protein liquid chromatography
FQ    	food questionnaire
FR    	food record
FRAP  	ferric reducing antioxidant power
FRC   	finely rolled corn
FRET  	fluorescence resonance energy transfer
FS    	foam stability
FSG   	functional specific gravity
FSR   	fractional synthesis rate
FSS   	Fatigue Severity Scale
FT    	fermentation time
FTA   	faecal tryptic activity
FTM   	Fluid thioglycollate medium
FU    	follow up
FWC   	Fecal water content
FY    	flour yield
FZCE  	free zone capillary electrophoresis
GA    	gluten ataxia
GAA   	Guanidino acetic acid
GACL  	generalized acquired cutis laxa
GAD   	glutamic acid decarboxylase
GADA  	glutamic acid decarboxylase autoantibodies
GAE   	Gallic Acid Equivalent
GAMS  	General Algebraic Modelling System
GARS  	Gilliam Autism Rating Scale
GBF   	germinated barley foodstuff
GBM   	gluten base medium
GBR   	germinated brown rice
GC    	gluten challenge
GCD   	gluten-sensitivity celiac disease
GCED  	Gluten Contamination Elimination Diet
GD    	gluten-containing diet
GDM   	gestational diabetes mellitus
GE    	gluten enteropathy
GEO   	Gene Expression Omnibus
GES   	gastric emptying scintigraphy
GF    	Gluten free
GFAP  	glial fibrillary acidic protein
GFC   	gel filtration chromatography
GFCF  	gluten free casein free
GFCFD 	gluten free casein free diet
GFD   	gluten free diet
GFF   	Gluten Friendly Flour
GFHFB 	Gluten Free Healthy Food Basket
GFP   	green fluorescent protein
GG    	guar gum
GH    	growth hormone
GHD   	growth hormone deficiency
GHI   	grain hardness index
GI    	Glycemic index
GIE   	gastrointestinal infectious episodes
GIN   	Guidelines International Network
GIP   	gluten immunogenic peptides
GISH  	genomic in situ hybridization
GL    	glycemic load
GLM   	GCN4 like motif
GM    	genetically modified
GMB   	gastric mucosal barrier
GMI   	Guaranteed Minimum Income
GMP   	grain maturation period
GMPH  	Green mussel protein hydrolysates
GMS   	glycerol mono stearate
GN    	Gluten neuropathy
GO    	Glucose oxidase
GP    	gliadin peptides
GPC   	grain protein content
GPT   	gluten protein types
GR    	glutathione reductase
GRD   	Gluten related disorders
GRE   	Golden Root Extract
GRS   	Glutinous rice starch
GS    	gluten sensitivity
GSE   	gluten sensitive enteropathy
GSP   	grain storage protein
GSRS  	Gastrointestinal Symptom Rating Scale
GSV   	grain sedimentation value
GT    	glutathione transferase
GTE   	green tea extract
GTP   	green tea polyphenols
GUESS 	Glasgow ultrasound enthesitis scoring system
GWAS  	Genome Wide Association Studies
GY    	grain yield
HA    	hereditary ataxia
HAQ   	Health Assessment Questionnaire
HB    	helical bundle
HBV   	hepatitis B virus
HC    	healthy controls
HCA   	hierarchical cluster analysis
HCD   	hydrolyzed casein diet
HCV   	hepatitis C virus
HD    	heading date
HDL   	high density lipoprotein
HE    	Hepatic encephalopathy
HF    	heated flour
HFM   	hydrolyzed feather meal
HG    	hydride generation
HHV   	human herpes virus
HI    	hydrolysis index
HIMEC 	human intestinal microvascular endothelial cells
HIPE  	high internal phase emulsion
HIV   	Human Immunodeficiency Virus
HL    	Hodgkin lymphoma
HLA   	human leukocyte antigen
HMGB1 	high mobility group box 1
HMM   	high molecular mass
HMW   	high molecular weight
HMWG  	high molecular weight glutenin
HOPG  	highly oriented pyrolytic graphite
HP    	Helicobacter pylori
HPCE  	high performance capillary electrophoresis
HPFS  	Health Professionals Follow-Up Study
HPLC  	High Performance Liquid Chromatography
HR    	hazard ratio
HRM   	high resolution melting
HRQOL 	health related quality of life
HRS   	hard red spring
HRT   	hormone replacement therapy
HRV   	heart rate variability
HS    	hepatic steatosis
HSA   	human serum albumin
HSC   	hematopoietic stem cells
HSCT  	hematopoietic stem cell transplantation
HSDS  	height standard deviation scores
HSL   	hormone sensitive lipase
HSP   	heat shock protein
HSR   	Health Star Rating
HSV   	herpes simplex virus
HT    	Hashimoto thyroiditis
HTS   	high throughput sequencing
HUC   	human umbilical cord
HUCV  	human umbilical cord vein
HUVEC 	human umbilical vein endothelial cells
HW    	Hard wheat
HWE   	hot water extract
HWG   	Hydrolyzed wheat gluten
HWP   	hydrolyzed wheat protein
IA    	islet autoimmunity
IAAO  	indicator amino acid oxidation
IACRS 	Inherited Ataxias Clinical Rating Scale
IAP   	intestinal alkaline phosphatase
IBD   	inflammatory bowel disease
IBR   	infectious bovine rhinotracheitis
IBS   	irritable bowel syndrome
IC    	inhibitory concentration
ICA   	islet cell antibodies
ICARS 	International Cooperative Ataxia Rating Scale
ICAT  	isotope coded affinity tags
ICC   	intraclass correlation coefficients
ICP   	inductively coupled plasma
ICUE  	idiopathic chronic ulcerative enteritis
ID    	iron deficiency
IDA   	Iron deficiency anemia
IDDM  	insulin dependent diabetes mellitus
IDF   	International Diabetes Federation
IE    	idiopathic epilepsy
IEC   	intestinal epithelial cell
IED   	intestinal effective digestibility
IFABP 	intestinal fatty acid binding protein
IG    	insoluble glutenin
IGC   	insoluble glutenin content
IGF   	insulin-like growth factor
IGF1  	insulin-like growth factor 1
IH    	Idiopathic hypoparathyroidism
IHD   	ischaemic heart disease
II    	intoxication index
IIM   	Idiopathic inflammatory myopathies
IL    	intraepithelial lymphocytosis
ILI   	immunological liver injury
ILN   	inguinal lymph node
IM    	Inflammatory myopathies
IMA   	ischemia modified albumin
IMD   	inherited metabolic disorders
INS   	idiopathic nephrotic syndrome
IOS   	iron-catalyzed oxidizing system
IP    	intestinal permeability
IPD   	idiopathic protracted diarrhoea
IPH   	Idiopathic pulmonary hemosiderosis
IPNV  	infectious pancreatic necrosis virus
IPP   	insoluble polymeric protein
IPT   	intestinal permeability test
IR    	insulin resistance
IRF   	interferon regulatory factor
IRMS  	Isotope Ratio Mass Spectrometer
IRR   	incidence risk ratios
IS    	Irish setter
ISBD  	inflammatory small bowel disease
ISC   	intestinal stem cell
ISH   	In situ hybridization
ISS   	idiopathic short stature
ITC   	isothermal titration calorimetry
ITF   	intestinal trefoil factor
ITP   	Idiopathic thrombocytopenic purpura
IVDMD 	in vitro dry matter disappearance
IVF   	in vitro fertilization
JDF   	Juvenile Diabetes Foundation
JE    	joint effusion
JHS   	joint hypermobility syndrome
JIA   	juvenile idiopathic arthritis
JRA   	juvenile rheumatoid arthritis
JSLE  	juvenile systemic lupus erythematosus
KGF   	Keratinocyte growth factor
KL    	Kraft lignin
KLH   	Keyhole limpet hemocyanin
LA    	lactic acid
LAB   	lactic acid bacteria
LAI   	leucocyte adherence inhibition
LAS   	linear alkylbenzene sulphonate
LASRC 	Lactic acid solvent retention capacity
LBG   	locust bean gum
LBM   	lean body mass
LBP   	LPS binding protein
LBT   	lactose breath test
LBW   	low birth weight
LC    	lymphocytic colitis
LCA   	life cycle assessment
LCB   	lower confidence bounds
LCD   	Low calorie diet
LCM   	Laser capture microdissection
LCR   	locus control region
LD    	lymphocytic duodenosis
LDA   	linear discriminant analysis
LDH   	layered double hydroxide
LDL   	low density lipoprotein
LE    	lymphocytic enteritis
LED   	light emitting diode
LF    	lupin flour
LFA   	lateral flow assays
LFD   	lateral flow device
LFM   	low-protein fish meal
LFT   	liver function tests
LG    	Lymphocytic gastritis
LGL   	large granular lymphocytes
LH    	lupine hull
LIF   	lymphocyte inhibition factor
LK    	lupine kernel
LL    	Lactococcus lactis
LM    	light microscopy
LMI   	leucocyte migration inhibition
LMIF  	leucocyte migration inhibition factor
LMW   	low molecular weight
LMWG  	low molecular weight glutenins
LOD   	limit of detection
LOQ   	limit of quantification
LP    	lamina propria
LPL   	lamina propria lymphocyte
LPMC  	lamina propria mononuclear cells
LPP   	Lipoma Preferred Partner
LR    	likelihood ratios
LRNI  	Lower Reference Nutrient Intake
LS    	liver stiffness
LSAS  	Liebowitz Social Anxiety Scale
LSI   	light scattering intensity
LSM   	laser scanning microscopy
LSSVM 	least squares support vector machine
LST   	lymphoblastic stimulation test
LSW   	light steep water
LTP   	lipid transfer protein
LTR   	long terminal repeat
LUQ   	left upper quadrant
LV    	left ventricle
LVEDD 	left ventricle end diastolic diameter
LVEF  	left ventricular ejection fraction
LVR   	linear viscoelastic region
MA    	mechanical activation
MAA   	metabolizable amino acid
MAD   	modified Atkins diet
MAF   	minor allele frequency
MAMP  	microbe associated molecular pattern
MAS   	magic angle spinning
MBD   	Metabolic bone disease
MBL   	mannose binding lectin
MC    	microscopic colitis
MCF   	modified corn fiber
MCM   	Mormon cricket meal
MCS   	Mental Component Score
MCV   	mean corpuscular volume
MD    	mean difference
MDD   	major depressive disorder
MDL   	method detection limit
MDSC  	modulated differential scanning calorimetry
ME    	metabolizable energy
MF    	maize flour
MFBT  	multi-stage fixed bed tower
MFF   	medium fine fraction
MFI   	Multidimensional Fatigue Inventory
MFN   	metabolic fecal nitrogen
MG    	myasthenia gravis
MGF   	maize gluten feed
MGM   	maize gluten meal
MGP   	mango ginger powder
MH    	mechanical hemolysis
MHC   	major histocompatibility complex
MHD   	mental health disorders
MHP   	magnesium hydrogen phosphate
MI    	mitotic index
MIC   	minimal inhibitory concentration
MIF   	migration inhibition factor
MIP   	molecularly imprinted polymer
ML    	minimal land
MLN   	mesenteric lymph nodes
MLPA  	multiplex ligation-dependent probe amplification
MLR   	multiple linear regression
MM    	Multiple myeloma
MMPI  	Minnesota Multiphasic Personality Inventory
MN    	membranous nephropathy
MNB   	menadione nicotinamide bisulfite
MNBT  	mobile nylon bag technique
MNT   	medical nutritional therapy
MO    	monkey oesophagus
MOS   	metmyoglobin oxidizing system
MP    	metabolizable protein
MPDI  	modified Paleolithic dietary intervention
MPI   	myocardial performance index
MPS   	muscle protein synthesis
MPU   	multi-frequency power ultrasound
MPV   	midline peak value
MR    	magnetic resonance
MRCA  	most recent common ancestor
MRI   	Magnetic resonance imaging
MRM   	multiple reaction monitoring
MRS   	magnetic resonance spectroscopy
MRT   	mean retention time
MS    	mass spectrometry
MSA   	multiple system atrophy
MSD   	mean squared displacement
MSM   	mechanical starch modification
MSR   	Malt Spent Rootlets
MSW   	municipal solid waste
MT    	mixing time
MTD   	maximum tolerated dose
MW    	molecular weight
MWB   	microparticulated wheat bran
MWD   	molecular weight distribution
MWG   	modified wheat gluten
MX    	Myxococcus xanthus
MYA   	million years ago
NA    	nucleic acid
NAS   	neutrophilic activity score
NBI   	nitrogen balance index
NC    	NC controls
NCD   	neglected coeliac disease
NCGS  	Non Celiac Gluten Sensitivity
NCP   	neuropathic corneal pain
NCSB  	northern-style Chinese steamed bread
ND    	normal diet
NDF   	neutral detergent fiber
NDG   	no detectable gluten
NDSU  	North Dakota State University
NE    	neutrophil elastase
NF    	nuclear factor
NFBG  	natural flour baked goods
NFID  	National Food Intolerance Database
NFR   	nuclear fluorescence reactivity
NGCB  	normal gluten content bread
NGF   	nerve growth factor
NGS   	next generation sequencing
NHANES	National Health and Nutrition Examination Survey
NHI   	Nitrogen harvest index
NHS   	National Health Service
NIT   	near infrared transmission
NK    	natural killer
NLS   	natren life start
NM    	nuclear matrix
NME   	Necrolytic migratory erythema
NMR   	nuclear magnetic resonance
NN    	normal noodle
NO    	nitric oxide
NOS   	not otherwise specified
NPR   	net protein ratio
NPU   	net protein utilization
NPV   	negative predictive value
NR    	N retention
NRC   	National Research Council
NS    	no supplement
NVM   	normal villous morphology
NZ    	New Zealand
NZW   	New Zealand White
O2    	Opaque 2
OCS   	Oral contraceptive steroids
OD    	optical density
OE    	ogaja extract
OES   	optical emission spectrometric
OFC   	oral food challenge
OFT   	open field test
OGB   	obscure GI bleeding
OI    	Osteogenesis imperfecta
OIAT  	oral iron absorption test
OLP   	oral lichen planus
OLR   	ordinal logistic regression
OM    	organic matter
OMS   	opsoclonus myoclonus syndrome
ON    	optic neuritis
ONLS  	Overall Neuropathy Limitations Scale
OP    	oxygen permeability
OPP   	orange pomace powder
OPT   	oral provocation test
OR    	Odds Ratio
ORAC  	oxygen radical absorbance capacity
ORF   	open reading frame
ORO   	Oil Red O
OSA   	obstructive sleep apnea
OSC   	orthogonal signal correction
OSI   	oxidative stress index
P4    	position 4
PA    	phytic acid
PAC   	predetermined asthma criteria
PAL   	physical activity level
PANSS 	Positive and Negative Symptoms Scale
PAP   	processed animal proteins
PB    	Prolamin box
PBC   	primary biliary cirrhosis
PBL   	peripheral blood lymphocytes
PBM   	poultry by-product meal
PBMC  	Peripheral blood mononuclear cells
PBS   	phosphate buffered saline
PC    	protein content
PCA   	Principal component analysis
PCD   	potential celiac disease
PCF   	posterior cranial fossa
PCI   	pneumatosis cystoides intestinalis
PCM   	protein calorie malnutrition
PCNA  	Proliferating cell nuclear antigen
PCR   	polymerase chain reaction
PCS   	Physical Component Score
PD    	paroxysmal dyskinesia
PDB   	Protein Data Bank
PDBF  	partially deffated baru flour
PDCAAS	protein digestibility corrected amino acid score
PDI   	protein disulfide isomerase
PE    	pulmonary emboli
PEC   	protein effectiveness coefficient
PED   	paroxysmal exertion-induced dyskinesia
PER   	protein efficiency ratio
PERT  	Pancreatic enzyme replacement therapy
PET   	positron emission tomography
PF    	preventive fraction
PFA   	palm fatty acids
PFGE  	pulsed field gel electrophoresis
PG    	Paralympic Games
PGE   	pencil graphite electrode
PH    	plant height
PHG   	partially hydrolyzed gluten
PHGG  	partially hydrolyzed guar gum
PI    	proliferation indices
PIC   	polymorphic information content
PICP  	procollagen I carboxyterminal propeptide
PIN   	protease insoluble N
PIP   	Psychotic In-Patient profile
PK    	pyruvate kinase
PKA   	protein kinase A
PKC   	protein kinase C
PKD   	paroxysmal kinesigenic dyskinesia
PLS   	partial least squares
PLSR  	partial least squares regression
PLT   	primed lymphocyte typing
PM    	poultry meal
PMF   	Pearl Millet Flour
PMR   	partial mixed rations
PN    	peripheral neuropathy
PNA   	protein network analysis
PND   	post natal day
PNG   	Papua New Guinea
PO    	palm oil
POC   	point of care
POD   	probability of detection
POE   	propagation of error
POF   	premature ovarian failure
POI   	primary ovarian insufficiency
POTS  	postural orthostatic tachycardia syndrome
PP    	pancreatic polypeptide
PPC   	pea protein concentrate
PPD   	purified protein derivative
PPI   	proton pump inhibitors
PPMS  	primary progressive multiple sclerosis
PPU   	proline protease units
PPV   	positive predictive value
PR    	Partial remission
PRF   	Pre-gelatinized rice flours
PRS   	Polygene Risk Score
PS    	potato starch
PSC   	primary sclerosing cholangitis
PSD   	pressure swing distillation
PSI   	particle size index
PSQ   	pediatric sleep questionnaire
PSQI  	Pittsburgh Sleep Quality Index
PSV   	protein storage vacuole
PT    	Prothrombin Time
PTA   	phase transition analysis
PTC   	premature termination codon
PTM   	Peiformance Tested MethodsSM
PUN   	plasma urea N
PV    	pemphigus vulgaris
PVA   	partial villous atrophy
PVE   	phenotypic variance explained
PW    	peak width
PWAG  	people who avoid gluten
PWCDAG	people without celiac disease avoiding gluten
PWE   	patients with epilepsy
PWV   	pulse wave velocity
QCM   	quartz crystal microbalance
QDA   	Quantitative Descriptive Analysis
QF    	quinoa flour
QIIME 	Quantitative Insights into Microbial Ecology
QOL   	quality of life
QPM   	Quality protein maize
QRT   	quantitative real time
QTL   	quantitative trait loci
RA    	rheumatoid arthritis
RAP   	Recurrent abdominal pain
RAPD  	random amplified polymorphic DNA
RAS   	Recurrent aphthous stomatitis
RAU   	recurrent aphthous ulcers
RB    	rice bran
RBA   	radioligand binding assay
RBC   	red blood cell
RBL   	rat basophilic leukemia
RCD   	Refractory coeliac disease
RCS   	Refractory coeliac sprue
RCT   	randomised controlled trials
RCV   	reference change value
RD    	regular diet
RDA   	Recommended Dietary Allowances
RDG   	rice dreg glutelin
RDP   	ruminally degradable protein
RDS   	rapidly digestible starch
REP   	Rochester Epidemiology Project
RET   	resonance energy transfer
RF    	rice flour
RFBB  	Rice flour based batter
RFD   	Refractory functional dyspepsia
RFI   	restricted feed intake
RFLP  	restriction fragment length polymorphism
RG    	Rice glutelin
RGM   	rice gluten meal
RH    	relative humidity
RI    	resistance index
RIL   	recombinant inbred lines
RKB   	red kidney bean
RLS   	restless legs syndrome
RM    	reference materials
RMR   	resting metabolic rate
ROA   	Raman optical activity
ROC   	Receiver operating characteristic
ROI   	regions of interest
ROS   	reactive oxygen species
ROU   	recurrent oral ulceration
RP    	Rectal prolapse
RPD   	relative prediction deviation
RPI   	rice protein isolate
RPL   	recurrent pregnancy loss
RR    	relative risk
RS    	resistant starch
RSD   	relative standard deviation
RSIS  	RNA silencing inducible sequence
RSM   	response surface methodology
RT    	reverse transcriptase
RTA   	renal tubular acidosis
RTE   	ready to eat
RTK   	Receptor Tyrosine Kinase
RUP   	rumen undegradable protein
RVA   	Rapid Visco Analysis
RWF   	refined wheat flour
RWJUH 	Robert Wood Johnson University Hospital
SA    	Salicylic acid
SAC   	systemic arterial compliance
SAT   	sugar absorption test
SB    	small bowel
SBB   	small bowel biopsy
SBCE  	small bowel capsule endoscopy
SBF   	simulated body fluid
SBM   	small bowel mucosa
SBP   	systolic blood pressure
SBWC  	small bowel water content
SC    	secretory component
SCA   	sickle cell anemia
SCD   	Seronegative coeliac disease
SCFA  	short chain fatty acids
SCG   	superficial chronic gastritis
SCN   	surface-modified cellulose nanowhiskers
SD    	standard deviation
SDB   	sleep disordered breathing
SDBA  	second derivative band area
SDE   	standardized dietician evaluation
SDF   	soluble dietary fiber
SDFU  	sequential dual frequency ultrasound
SDR   	standard deviation ratio
SDRI  	starch digestive rate index
SDS   	sodium dodecyl sulfate
SDSS  	sodium dodecyl sulfate sedimentation
SE    	softness equivalent
SEC   	Size exclusion chromatography
SEM   	Scanning electron microscopy
SERS  	surface enhanced Raman spectroscopy
SF    	survival fraction
SFC   	spot forming cells
SFN   	Small fiber neuropathy
SG    	starch gelatinization
SGF   	simulated gastric fluid
SH    	soybean hulls
SHP   	SPA Heterodimerizing Protein
SHR   	spontaneously hypertensively rats
SI    	stimulation index
SIB   	small intestinal biopsy
SIBO  	small intestinal bacterial overgrowth
SID   	standardized ileal digestible
SIDA  	stable isotope dilution assays
SIH   	stress induced hyperthermia
SIL   	Small intestinal lymphocytes
SIM   	small intestinal mucosa
SIR   	Standardised incidence ratios
SIRA  	stable isotope ratio analysis
SK    	saturation kinetics
SLE   	systemic lupus erythematosus
SLI   	Secondary lactose intolerance
SLM   	scanning laser microscope
SLV   	specific loaf volume
SM    	soybean meal
SMD   	Standardised Mean Difference
SME   	specific mechanical energy
SMLM  	single molecule localization microscopy
SMP   	skimmed milk powder
SMR   	standardized mortality ratio
SMRT  	Single Molecule Real Time
SMS   	secondary malabsorption syndrome
SNP   	single nucleotide polymorphism
SO    	sardine oil
SOCS  	suppressor of cytokine signaling
SOE   	strength of evidence
SOM   	secretory otitis media
SOP   	standard operating procedure
SP    	soy protein
SPA   	Storage protein activator
SPC   	soy protein concentrate
SPE   	Soy protein elastomer
SPECT 	single photon emission computed tomography
SPI   	soy protein isolate
SPL   	Serum prolactin levels
SPM2  	Statistical Parametric Mapping 2
SPMS  	secondary progressive multiple sclerosis
SPS   	Sweet potato starch
SPT   	Skin prick test
SPV   	sweet potato vermicelli
SQ    	sensory quality
SR    	systematic reviews
SRBC  	sheep red blood cells
SRC   	solvent retention capacity
SRCD  	synchrotron radiation circular dichroism
SRF   	straight run flour
SRM   	selected reaction monitoring
SRR   	standardized registration ratio
SS    	Short stature
SSC   	Somatization Symptom Checklist
SSE   	shrimp soluble extract
SSF   	squash seed flour
SSL   	sodium stearoyl lactylate
SSP   	seed storage protein
SSR   	simple sequence repeat
SSRI  	selective serotonin reuptake inhibitors
ST    	stability time
STM   	Scanning tunnelling microscopy
STPI  	State Trait Personality Inventory
STTD  	standardized total tract digestibility
SV    	sedimentation value
SVA   	severe villous atrophy
SW    	specific weight
T1D   	type one diabetes
T1DM  	type one diabetes mellitus
T2D   	type two diabetes
TA    	Thyroid autoimmunity
TAAA  	true amino acid availability
TAC   	total antioxidant capacity
TAD   	thyroid autoimmune diseases
TAS   	total antioxidant status
TAXI  	Triticum aestivum xylanase inhibitor
TBBMC 	total body bone mineral content
TBBMD 	total body bone mineral density
TBI   	traumatic brain injury
TBM   	Total bone mass
TBW   	total body water
TC    	total cholesterol
TCC   	T cell clones
TCD   	treated celiac disease
TCL   	T cell lines
TCR   	T cell receptor
TD    	thermal desorption
TDE   	tissue Doppler echocardiography
TDF   	total dietary fiber
TDI   	tissue Doppler imaging
TDT   	transmission disequilibrium test
TE    	terrestrial eutrophication
TEAC  	Trolox Equivalent Antioxidant Capacity
TEE   	total energy expenditure
TEM   	transmission electron microscopy
TER   	transepithelial electrical resistance
TF    	tef flour
TFC   	total fecal collection
TFF   	trefoil factor family
TGA   	thermo gravimetric analysis
TGF   	transforming growth factor
TGI   	transient gluten intolerance
TGW   	thousand grain weight
TH    	thermal hysteresis
TI    	therapeutic impact
TIA   	T-cell intracellular antigen
TIBC  	total iron binding capacity
TIPD  	true ileal P digestibility
TJ    	tight junction
TJP1  	tight junction protein 1
TJP2  	tight junction protein 2
TKW   	thousand kernel weight
TLE   	temporal lobe epilepsy
TLR2  	Toll like receptors 2
TLR5  	Toll like receptor 5
TM    	transverse myelitis
TME   	True metabolizable energy
TMR   	total mixed ration
TMS   	transcranial magnetic stimulation
TN    	Total nitrogen
TNF   	tumor necrosis factor
TNSS  	Total Nasal Symptom Score
TOC   	total oxidant capacity
TOR   	target of rapamycin
TOS   	total oxidant status
TP    	Total protein
TPA   	texture profile analysis
TPC   	Total phenolic content
TPN   	total parenteral nutrition
TRF   	telomere restriction fragments
TS    	Turner syndrome
TSF   	tomato seed flour
TSH   	thyroid stimulating hormone
TSP   	total soluble protein
TST   	Tuberculin skin test
TT    	triple test
TTA   	total titratable acidity
TTTD  	true total tract digestibility
TVA   	total villous atrophy
TVP   	textured vegetable protein
TW    	test weight
TWH   	tomato waste hydrolysate
UAMA  	upper arm muscle area
UC    	ulcerative colitis
UCC   	University Clinical Centre
UCD   	untreated coeliac disease
UD    	unbalanced distribution
UDH   	untreated dermatitis herpetiformis
UDMS  	Ultra Definition Mass Spectrometry
UEA   	Ulex europaeus agglutinin
UIBC  	unsaturated iron binding capacity
UIP   	undegradable intake protein
UJ    	ulcerative jejunitis
UK    	United Kingdom
UP    	Ubiquitin Proteasome
UPP   	unextractable polymeric protein
US    	United States
USOP  	Ultrasonicated squid ovary powder
VA    	villous atrophy
VABS  	Vineland Adaptive Behaviour Scales
VAS   	visual analogue scale
VBF   	vacuum belt filtration
VBM   	voxel based morphometry
VBTL  	Vaccinium bracteatum Thunb leaf
VCE   	video capsule endoscopy
VE    	vitamin E
VEGF  	vascular endothelial growth factor
VEGFA 	Vascular endothelial growth factor A
VFA   	volatile fatty acids
VG    	vital gluten
VH    	variable hypogammaglobulinemia
VI    	viscoelastic index
VL    	vastus lateralis
VLDL  	very low density lipoproteins
VOC   	volatile organic compounds
VP    	vegetable protein
VWG   	Vital Wheat Gluten
WA    	wheat allergy
WAI   	water absorption index
WAR   	water absorption ratio
WB    	wheat bran
WBC   	water binding capacity
WBDF  	Wheat bran dietary fiber
WBG   	wet brewers grains
WC    	whole corn
WCB   	wet corn bran
WCE   	wireless capsule endoscopy
WCF   	water chestnut flour
WCGF  	wet corn gluten feed
WD    	Western diet
WDEIA 	wheat dependent exercise induced anaphylaxis
WF    	wheat flour
WFA   	wheat food allergy
WFBB  	wheat flour based batter
WG    	wheat gluten
WGA   	wheat germ agglutinin
WGH   	Wheat gluten hydrolysate
WGO   	World Gastroenterology Organization
WGP   	wheat gluten protein
WGWF  	whole grain wheat flour
WHC   	water holding capacity
WHO   	World Health Organization
WI    	whey isolate
WM    	white matter
WMS   	wasting marmoset syndrome
WP    	wheat protein
WPBF  	Wheat prolamin-box binding factor
WPC   	whey protein concentrate
WPI   	whey protein isolate
WS    	wheat straw
WSI   	water solubility index
WSMV  	wheat streak mosaic virus
WU    	water uptake
WVP   	water vapor permeability
WVTR  	water vapor transmission rate
WWB   	whole wheat bread
WWD   	whole wheat dough
WWF   	Whole Wheat Flour
XANES 	X-ray absorption near edge structure
XG    	xanthan gum
XI    	Xerostomia Inventory
XIP   	xylanase inhibitor protein
XPS   	X-ray photoelectron spectroscopy
YE    	yeast extract
YGTSS 	Yale Global Tics Severity Scale
YH    	yeast hydrolysate
YM    	yellow maize
ZO    	Zonula occludens
ZSV   	Zeleny sedimentation value
